15 5

1 1 1 1 1 1 1 1 1 1 1 1 1 1 1 
1 1 1 1 1 1 1 1 1 1 1 1 1 1 1 
1 1 1 1 1 1 1 1 1 1 1 1 1 1 1 
1 1 1 1 1 1 1 1 1 1 1 1 1 1 1 
1 1 1 1 1 1 1 1 1 1 1 1 1 1 1 

1 1 1 1 1 1 1 1 1 1 1 1 1 1 1 
1 0 0 0 0 0 0 0 0 7 0 0 0 0 1 
1 0 0 0 0 0 0 0 0 0 0 0 0 0 1 
1 0 0 0 0 0 0 0 0 0 0 0 12 10 19 
1 1 1 1 1 1 1 1 1 1 1 1 21 21 1 

0 0 3 3 0 0 0 3 0 0 0 0 3 0 3 
3 0 0 0 0 0 0 4 0 3 0 0 0 0 0 
0 0 0 0 0 4 0 0 0 0 0 0 0 0 0 
0 6 0 0 1 0 0 0 0 0 0 0 0 0 3 
3 3 0 0 0 3 0 3 0 0 0 0 0 3 0 