20 12

1 1 1 1 1 1 1 1 1 1 1 1 1 1 1 1 1 1 1 1 
1 1 1 1 1 1 1 1 1 1 1 1 1 1 1 1 1 1 1 1 
1 1 1 1 1 1 1 1 1 1 1 1 1 1 1 1 1 1 1 1 
1 1 1 1 1 1 1 1 1 1 1 1 1 1 1 1 1 1 1 1 
1 1 1 1 1 1 1 1 1 1 1 1 1 1 1 1 1 1 1 1 
1 1 1 1 1 1 1 1 1 1 1 1 1 1 1 1 1 1 1 1 
1 1 1 1 1 1 1 1 1 1 1 1 1 1 1 1 1 1 1 1 
1 1 1 1 1 1 1 1 1 1 1 1 1 1 1 1 1 1 1 1 
1 1 1 1 1 1 1 1 1 1 1 1 1 1 1 1 1 1 1 1 
1 1 1 1 1 1 1 1 1 1 1 1 1 1 1 1 1 1 1 1 
1 1 1 1 1 1 1 1 1 1 1 1 1 1 1 1 1 1 1 1 
1 1 1 1 1 1 1 1 1 1 1 1 1 1 1 1 1 1 1 1 

1 1 1 1 1 1 1 1 1 1 1 1 1 1 1 1 1 1 1 1 
1 4 0 0 0 0 0 0 0 0 0 0 0 0 0 0 0 0 0 1 
1 0 0 0 0 0 0 0 0 0 0 0 0 0 0 0 0 0 0 1 
1 0 0 0 0 0 0 0 0 0 0 0 0 0 18 10 10 10 19 1 
1 1 1 1 1 1 8 0 0 0 0 0 0 0 0 0 0 0 0 1 
1 0 0 0 0 0 0 0 0 0 0 0 0 0 0 0 0 0 0 1 
1 0 0 0 0 0 0 0 0 0 0 0 0 0 0 0 0 0 0 1 
1 0 0 0 0 0 0 0 0 0 0 0 0 3 1 1 1 1 1 1 
1 0 0 0 0 0 0 0 0 0 0 0 0 7 0 0 0 0 5 1 
1 0 0 0 0 0 0 0 3 2 0 0 0 0 0 0 0 0 9 1 
1 0 0 0 0 0 0 0 1 1 0 0 0 0 0 0 0 0 3 1 
1 1 1 1 1 1 1 1 1 1 1 1 1 1 1 1 1 1 1 1 

3 0 0 3 0 0 0 3 0 0 0 0 3 0 0 3 0 0 0 3 
3 0 0 4 0 0 0 0 0 0 0 4 0 0 5 0 0 0 0 3 
0 0 0 0 0 0 0 0 0 0 0 0 0 0 0 0 0 2 1 0 
0 1 0 0 0 0 0 0 0 0 0 0 0 0 0 0 0 0 0 3 
0 3 3 0 0 3 0 0 0 0 0 0 0 0 0 0 0 0 4 0 
0 0 0 0 0 0 0 0 0 0 0 0 0 0 0 0 0 0 0 0 
3 0 0 0 0 0 0 0 0 0 0 0 0 0 0 0 1 0 0 3 
0 0 0 0 5 0 0 0 0 0 0 0 0 0 3 3 0 0 0 3 
0 0 0 0 0 0 0 0 0 0 0 0 0 0 0 4 0 0 0 0 
3 0 0 0 0 0 0 0 3 0 0 0 0 0 0 0 0 4 0 3 
3 0 6 0 1 0 0 0 0 3 0 0 0 0 0 0 1 2 3 0 
0 0 3 0 0 0 3 0 3 0 0 0 3 3 0 0 0 0 0 3 